8 10
&-~-~#~-  
+ +~--  -+
~-#---~---
 +---+--~-
-   -+----
-   - -   
++----~-- 
   ~&-+   