8 12
--+--~-++- ~
- - ~ ++-#+~
--  --~~-+~-
---+--~~----
- --- +  ---
- - -~--~--+
--- ~ - ----
&-----~+--  
